30 30
44 45 102 43 44 44 44 44 44 44 44 44 44 44 44 44 44 44 44 44 44 44 44 44 44 44 44 44 44 44 
41 42 103 40 41 78 52 41 78 41 41 78 41 41 78 41 41 78 41 51 78 41 41 78 41 41 78 41 41 41 
41 42 101 40 52 41 41 41 41 51 41 41 41 41 41 41 41 41 41 52 41 41 41 41 41 41 41 41 52 41 
42 24 25 25 25 25 25 25 25 25 25 25 25 25 25 25 25 25 25 25 25 25 25 25 25 25 25 25 26 40 
42 27 28 28 28 28 28 28 28 28 28 28 28 28 28 28 28 28 28 28 28 28 28 28 28 28 28 28 29 40 
42 30 35 36 31 31 31 31 31 31 31 31 31 31 31 31 31 31 31 35 36 31 31 31 31 31 31 35 29 40 
41 42 27 29 43 44 44 44 44 44 44 44 44 44 44 44 44 44 45 27 29 43 44 44 44 44 45 27 29 40 
41 42 27 29 40 41 51 41 41 41 41 41 41 41 41 41 51 41 42 27 29 40 41 41 41 41 42 27 29 40 
41 42 27 29 40 41 41 41 41 41 41 41 41 41 41 41 41 41 42 27 29 40 51 41 52 41 42 27 29 40 
41 42 27 29 40 41 41 41 41 41 41 41 41 41 41 41 41 41 42 27 29 40 41 41 41 41 42 27 29 40 
41 42 27 29 40 41 41 52 41 41 41 41 51 41 41 41 42 24 25 33 29 40 41 41 41 41 42 27 29 40 
41 42 27 29 40 41 41 41 41 41 41 41 41 41 41 41 42 27 36 31 32 40 41 41 51 41 42 27 29 40 
41 42 27 29 40 42 24 25 25 25 26 40 41 41 41 41 42 27 29 43 44 41 41 41 41 41 42 27 29 40 
41 42 27 29 40 42 27 36 31 31 32 40 41 41 52 41 42 27 29 40 41 41 42 24 25 25 25 33 29 40 
41 42 27 29 40 42 27 29 43 44 44 41 41 41 41 41 42 27 29 40 41 41 42 27 36 31 31 31 32 40 
41 42 27 29 40 42 27 29 40 51 52 41 42 24 25 25 25 33 29 40 51 41 42 27 29 43 44 44 44 41 
41 42 27 34 25 25 33 34 25 25 26 40 42 27 36 31 31 31 32 40 41 41 42 27 29 40 41 41 41 41 
41 42 30 31 31 31 31 31 31 35 29 40 42 27 29 43 44 44 44 41 41 41 42 27 29 40 41 52 41 41 
41 41 44 44 44 44 44 44 45 27 29 40 42 27 29 40 41 41 41 41 41 41 42 27 29 40 41 41 41 41 
41 41 51 41 41 52 41 41 42 27 29 40 42 27 34 25 25 26 40 42 24 25 25 33 29 40 41 41 41 41 
42 24 25 25 25 25 26 40 42 27 29 40 42 30 31 31 35 29 40 42 30 31 31 31 32 40 41 51 41 41 
42 27 36 31 31 35 29 40 42 27 29 40 41 44 44 45 27 29 40 41 44 44 44 44 44 41 41 41 41 41 
42 27 29 43 45 27 34 25 25 33 29 40 51 41 41 42 27 29 40 41 52 41 41 41 41 41 41 41 41 41 
42 27 29 40 42 30 31 35 36 31 32 40 41 41 41 42 27 34 25 25 25 25 25 25 25 25 25 25 26 40 
42 27 29 40 41 44 45 27 29 43 44 41 41 41 52 42 30 31 31 31 31 31 31 31 31 31 31 35 29 40 
42 27 29 40 41 41 42 30 32 40 41 41 41 41 41 41 44 44 44 44 44 44 44 44 44 44 45 27 29 40 
42 27 29 40 41 41 41 44 44 41 41 42 24 26 40 41 41 41 41 41 41 41 41 51 52 41 42 27 29 40 
42 27 29 40 52 41 41 41 41 51 41 42 27 29 40 41 41 51 41 41 41 41 41 41 41 41 42 27 29 40 
42 27 34 25 25 25 25 25 25 25 25 25 33 34 25 25 25 25 25 25 25 26 40 42 24 25 25 33 29 40 
42 30 31 31 31 31 31 31 31 31 31 31 31 31 31 31 31 31 31 31 31 32 40 42 30 31 31 31 32 40 