45 45
49 49 50 102 48 49 49 49 49 49 49 49 49 49 49 49 49 49 49 49 49 49 49 49 49 49 49 49 49 49 49 49 49 49 49 49 49 49 49 49 49 49 49 49 49 
49 49 50 103 48 49 49 49 49 49 49 49 49 49 49 49 49 49 49 49 49 49 49 49 49 49 49 49 49 49 49 49 49 49 49 49 49 49 49 49 49 49 49 49 49 
49 49 50 101 48 49 49 49 49 49 49 49 49 49 49 49 49 49 49 49 49 49 49 49 49 49 49 49 49 49 49 49 49 49 49 49 49 49 49 49 49 49 49 49 49 
49 49 50 25 48 50 24 25 25 25 25 25 25 25 25 25 25 25 25 25 25 25 26 48 49 49 49 49 50 24 25 25 25 25 26 48 50 24 25 25 25 25 26 48 49 
49 49 50 28 48 50 27 28 36 31 31 31 31 31 31 31 31 35 36 31 31 35 29 48 49 49 49 49 50 27 36 31 31 35 29 48 50 27 28 28 28 28 29 48 49 
50 24 25 28 25 25 33 28 29 48 49 49 49 49 49 49 50 27 29 48 50 27 34 25 25 25 26 48 50 27 29 48 50 27 29 48 50 27 36 31 31 35 29 48 49 
50 27 36 31 31 31 31 31 32 48 49 49 49 49 49 49 50 27 29 48 50 30 31 31 31 35 29 48 50 27 29 48 50 27 29 48 50 27 29 48 50 27 29 48 49 
50 27 29 48 49 49 49 49 49 49 50 24 25 25 25 25 25 28 29 48 49 49 49 49 50 27 29 48 50 27 29 48 50 27 29 48 50 27 29 48 50 27 29 48 49 
50 27 29 48 49 49 49 49 49 49 50 27 36 31 31 31 31 35 29 48 49 49 49 49 50 27 29 48 50 27 29 48 50 27 29 48 50 27 29 48 50 27 29 48 49 
50 27 34 25 25 25 25 25 25 25 25 33 29 48 49 49 50 27 29 48 50 24 26 48 50 27 34 25 25 33 29 48 50 27 29 48 50 27 29 48 50 27 29 48 49 
50 27 36 31 31 31 31 35 36 31 31 35 29 48 49 49 50 27 29 48 50 27 29 48 50 30 31 31 31 35 29 48 50 27 29 48 50 27 29 48 50 27 29 48 49 
50 27 29 48 49 49 50 27 29 48 50 27 34 25 25 25 25 33 34 25 25 33 29 48 49 49 49 49 50 27 29 48 50 27 29 48 50 27 29 48 50 27 29 48 49 
50 27 29 48 49 49 50 27 29 48 50 30 31 35 36 31 31 35 36 31 31 35 29 48 49 49 49 49 50 27 29 48 50 27 29 48 50 27 29 48 50 27 29 48 49 
50 27 34 25 26 49 50 27 29 48 49 49 50 27 29 48 50 27 29 48 50 27 34 25 25 25 25 25 25 33 29 48 50 27 28 25 25 33 29 48 50 27 29 48 49 
50 30 31 35 29 49 50 27 29 48 49 49 50 27 29 48 50 27 29 48 50 30 31 31 31 31 31 31 31 35 29 48 50 27 36 31 31 31 32 48 50 27 29 48 49 
49 49 50 27 29 49 50 27 29 48 50 24 25 33 29 48 50 27 29 48 49 49 49 49 49 49 49 49 50 27 29 48 50 27 29 48 49 49 49 49 50 27 29 48 49 
49 49 50 27 29 49 50 27 29 48 50 27 36 31 32 48 50 27 29 48 49 49 49 49 49 49 49 49 50 27 29 48 50 27 29 48 49 49 49 49 50 27 29 48 49 
50 24 25 33 29 49 50 27 34 25 25 33 29 48 49 49 50 27 29 48 50 24 25 25 25 25 26 48 50 27 29 48 50 27 28 25 25 25 26 48 50 27 29 48 49 
50 27 36 31 32 49 50 27 36 31 31 35 29 48 49 49 50 27 29 48 50 30 31 31 31 35 29 48 50 27 29 48 50 27 36 31 31 31 32 48 50 27 29 48 49 
50 27 29 48 49 49 50 27 29 48 50 27 29 48 49 24 25 33 29 48 49 49 49 49 50 27 29 48 50 27 29 48 50 27 29 48 49 49 49 49 50 27 29 48 49 
50 27 29 48 49 49 50 27 29 48 50 27 29 48 49 27 28 28 29 48 49 49 49 49 50 27 29 48 50 27 29 48 50 27 29 48 49 49 49 49 50 27 29 48 49 
50 27 29 48 49 24 25 33 29 48 50 27 29 48 49 27 28 28 29 48 50 24 25 25 25 33 29 48 50 27 34 25 25 33 29 48 50 24 25 25 25 33 29 48 49 
50 27 29 48 49 30 31 35 29 48 50 27 29 48 49 30 31 31 32 48 50 27 36 31 31 31 32 48 50 30 31 31 31 31 32 48 50 27 36 31 31 35 29 48 49 
50 27 29 48 49 49 50 27 29 48 50 27 29 48 49 49 49 49 49 49 50 27 29 48 49 49 49 49 49 49 49 49 49 49 49 49 50 27 29 48 50 27 29 48 49 
50 27 29 48 49 49 50 27 29 48 50 27 29 48 49 49 49 49 49 49 50 27 29 48 49 49 49 49 49 49 49 49 49 49 49 49 50 27 29 48 50 27 29 48 49 
50 27 28 25 25 25 25 33 29 48 50 27 34 25 25 25 25 25 26 48 50 27 34 25 25 25 25 25 25 25 25 25 26 48 50 24 25 33 29 48 50 27 29 48 49 
50 27 36 31 31 31 31 31 32 48 50 30 31 31 31 35 36 31 32 48 50 30 31 31 31 31 31 31 31 31 31 35 29 48 50 27 36 31 32 48 50 27 29 48 49 
50 27 29 48 49 49 49 49 49 49 49 49 49 49 50 27 29 48 49 49 49 49 49 49 49 49 49 49 49 49 50 27 29 48 50 27 29 48 49 49 50 27 29 48 49 
50 27 29 48 49 49 49 49 49 49 49 49 49 49 50 27 29 48 49 49 49 49 49 49 49 49 49 49 49 49 50 27 29 48 50 27 29 48 49 49 50 27 29 48 49 
50 27 34 25 25 25 25 25 25 25 25 25 25 25 25 33 34 25 26 48 49 49 49 49 50 24 26 48 49 49 50 27 29 48 50 27 29 48 50 24 25 33 29 48 49 
50 27 36 31 31 35 36 31 31 35 36 31 31 31 31 31 31 31 32 48 49 49 49 49 50 27 29 48 49 49 50 27 29 48 50 27 29 48 50 27 36 31 32 48 49 
50 27 29 48 50 27 29 48 49 27 29 48 49 49 49 49 49 49 49 49 49 49 49 49 50 27 29 48 50 24 25 33 29 48 50 27 29 48 50 27 29 48 49 49 49 
50 27 29 48 50 27 29 48 49 27 29 48 49 49 49 49 49 49 49 49 49 49 49 49 50 27 29 48 50 27 36 31 32 48 50 27 29 48 50 27 29 48 49 49 49 
50 27 29 48 50 27 29 48 49 27 34 25 25 25 25 25 25 25 25 25 25 25 25 25 25 33 29 48 50 27 29 48 49 49 50 27 29 48 50 27 34 25 26 48 49 
50 27 29 48 50 27 29 48 49 30 31 31 31 31 31 31 31 35 36 31 31 31 31 31 31 31 32 48 50 27 29 48 49 49 50 27 29 48 50 30 31 35 29 48 49 
50 27 29 48 50 27 29 48 49 49 49 49 49 49 49 49 50 27 29 48 49 49 49 49 49 49 49 49 50 27 29 48 50 24 25 33 34 25 26 48 50 27 29 48 49 
50 27 29 48 50 27 29 48 49 49 49 49 49 49 49 49 50 27 29 48 49 49 49 49 49 49 49 49 50 27 29 48 50 27 36 31 31 31 32 48 50 27 29 48 49 
50 27 29 48 50 27 28 25 25 25 25 25 25 25 25 25 25 33 34 25 25 25 25 25 25 25 26 48 50 27 29 48 50 27 29 48 49 49 50 24 25 33 29 48 49 
50 27 29 48 50 30 31 31 31 31 31 31 31 31 31 31 31 31 31 31 31 31 31 35 36 31 32 48 50 27 29 48 50 30 32 48 49 49 50 30 31 35 29 48 49 
50 27 29 48 49 49 49 49 49 49 49 49 49 49 49 49 49 49 49 49 49 49 50 27 29 48 49 49 50 27 29 48 49 49 50 24 25 25 26 48 50 27 29 48 49 
50 27 29 48 49 49 49 49 49 49 49 49 49 49 49 49 49 49 49 49 49 49 50 27 29 48 49 49 50 27 29 48 49 49 50 27 28 28 29 48 50 27 29 48 49 
50 27 34 25 25 25 25 25 25 25 25 25 25 25 25 25 25 25 25 25 25 25 25 33 34 25 26 48 50 27 34 25 25 25 25 33 28 28 34 25 25 33 29 48 49 
50 30 31 31 31 31 31 31 31 31 31 31 31 31 31 31 31 31 31 31 31 31 31 31 31 31 32 48 50 30 31 31 31 31 31 31 31 31 31 31 31 31 32 48 49 
49 49 49 49 49 49 49 49 49 49 49 49 49 49 49 49 49 49 49 49 49 49 49 49 49 49 49 49 49 49 49 49 49 49 49 49 49 49 49 49 49 49 49 49 49 
49 49 49 49 49 49 49 49 49 49 49 49 49 49 49 49 49 49 49 49 49 49 49 49 49 49 49 49 49 49 49 49 49 49 49 49 49 49 49 49 49 49 49 49 49 