25 25
102 102 102 102 102 102 102 102 102 102 102 102 102 102 102 102 102 102 102 102 102 102 102 102 102 
102 102 43 44 44 44 44 44 45 102 102 102 102 102 102 102 102 102 102 102 102 102 102 102 102 
102 102 40 78 42 102 40 78 42 102 102 102 102 102 102 102 102 102 102 102 102 102 102 102 102 
102 102 40 41 42 103 40 41 42 102 102 102 102 102 102 102 102 102 102 102 102 102 102 102 102 
102 102 40 41 42 101 40 41 42 102 102 102 102 102 102 102 102 102 102 102 102 102 102 102 102 
102 102 102 102 42 1 40 102 102 102 102 102 102 102 102 102 102 102 102 102 102 102 102 102 102 
102 102 102 102 42 1 40 102 102 102 102 102 102 102 102 102 102 102 102 102 102 102 102 102 102 
102 102 102 102 42 1 40 102 102 102 102 102 102 102 102 102 102 102 102 102 102 102 102 102 102 
102 102 102 102 42 1 40 102 102 102 102 102 102 102 102 102 102 102 102 102 102 102 102 102 102 
102 102 102 41 41 1 41 41 41 41 41 41 102 102 102 102 102 102 102 102 102 102 102 102 102 
102 102 102 41 1 1 41 1 1 1 1 41 41 41 41 102 102 102 102 102 102 102 102 102 102 
102 102 102 41 41 1 41 1 1 1 41 41 1 1 41 102 102 102 102 102 102 102 102 102 102 
102 102 102 102 41 1 1 1 1 1 1 1 1 1 41 102 102 102 102 102 102 102 102 102 102 
102 102 102 102 41 41 41 1 1 1 41 1 1 1 41 102 102 102 102 102 102 102 102 102 102 
102 102 102 102 102 102 41 41 1 1 41 41 41 41 41 102 102 102 102 102 102 102 102 102 102 
102 102 102 102 102 102 102 41 41 41 41 102 102 102 102 102 102 102 102 102 102 102 102 102 102 
102 102 102 102 102 102 102 102 102 102 102 102 102 102 102 102 102 102 102 102 102 102 102 102 102 
102 102 102 102 102 102 102 102 102 102 102 102 102 102 102 102 102 102 102 102 102 102 102 102 102 
102 102 102 102 102 102 102 102 102 102 102 102 102 102 102 102 102 102 102 102 102 102 102 102 102 
102 102 102 102 102 102 102 102 102 102 102 102 102 102 102 102 102 102 102 102 102 102 102 102 102 
102 102 102 102 102 102 102 102 102 102 102 102 102 102 102 102 102 102 102 102 102 102 102 102 102 
102 102 102 102 102 102 102 102 102 102 102 102 102 102 102 102 102 102 102 102 102 102 102 102 102 
102 102 102 102 102 102 102 102 102 102 102 102 102 102 102 102 102 102 102 102 102 102 102 102 102 
102 102 102 102 102 102 102 102 102 102 102 102 102 102 102 102 102 102 102 102 102 102 102 102 102 
102 102 102 102 102 102 102 102 102 102 102 102 102 102 102 102 102 102 102 102 102 102 102 102 102 