40 40
48 50 102 48 49 49 49 49 49 49 49 49 49 49 49 49 49 49 49 49 49 49 49 49 49 49 49 49 49 49 49 49 49 49 49 49 49 49 49 50 
48 50 103 48 49 49 49 49 49 49 49 49 49 49 49 49 49 49 49 49 49 49 49 49 49 49 49 49 49 49 49 49 49 49 49 49 49 49 49 50 
48 50 101 48 49 49 49 49 49 49 49 49 49 49 49 49 49 49 49 49 49 49 49 49 49 49 49 49 49 49 49 49 49 49 49 49 49 49 49 50 
48 1 1 1 1 1 1 1 1 1 1 1 1 1 1 1 1 1 1 1 1 1 1 1 3 1 1 1 1 1 1 1 1 1 1 1 1 1 13 50 
48 49 49 49 49 50 1 48 49 49 49 49 49 49 49 49 49 49 49 49 49 49 49 49 49 49 49 49 49 49 49 49 49 50 1 48 49 49 49 50 
48 1 1 3 1 1 1 48 1 1 1 1 1 1 1 1 1 1 1 1 1 1 1 1 1 1 1 1 1 1 1 1 1 1 1 1 1 15 12 50 
48 1 48 49 49 49 1 48 10 49 49 49 49 49 49 49 49 49 49 49 49 49 50 1 48 49 49 49 49 49 49 49 49 49 49 49 2 50 14 50 
48 1 1 13 10 49 1 48 49 49 1 1 1 1 1 1 1 1 1 1 49 1 1 1 1 1 1 1 1 1 1 1 1 1 1 1 15 50 1 50 
48 1 48 49 14 49 1 1 1 1 1 49 49 49 49 49 49 49 50 1 49 1 49 49 49 49 49 49 49 49 49 49 49 49 1 1 1 50 1 50 
48 1 48 49 1 49 49 49 49 49 49 49 1 1 1 1 1 1 50 1 49 1 49 1 1 1 1 1 1 1 1 1 1 49 1 48 49 50 1 50 
48 1 1 49 1 1 1 1 1 1 1 1 1 1 48 49 49 1 50 1 49 1 49 1 48 49 49 49 49 49 49 50 1 49 1 1 1 1 3 50 
48 50 1 49 4 48 49 49 49 49 49 49 50 1 48 14 49 1 50 1 49 3 49 1 48 1 1 1 1 1 1 50 1 49 49 49 49 50 1 50 
48 13 12 49 6 1 1 1 1 1 1 1 50 1 48 1 49 1 50 1 49 1 49 1 48 1 48 49 49 49 49 50 1 49 6 1 1 1 1 50 
48 9 48 49 1 48 49 49 49 49 49 49 50 1 48 1 49 12 50 1 49 1 49 1 48 1 1 1 3 1 1 50 1 49 1 49 2 50 1 50 
48 9 12 49 1 1 1 1 1 1 1 1 50 1 48 1 49 49 50 1 49 1 49 1 48 49 49 49 49 50 1 50 1 49 1 49 1 50 1 50 
48 50 8 49 49 49 49 49 50 1 1 1 1 3 3 1 1 1 1 1 49 1 49 1 48 13 8 1 1 1 1 50 1 49 1 49 1 50 1 50 
48 15 14 49 1 1 1 1 13 10 48 49 49 49 49 49 49 49 49 49 49 1 49 3 48 50 11 48 49 49 49 50 1 49 1 49 1 50 1 50 
48 1 48 49 49 49 49 49 49 15 12 1 1 1 1 1 1 1 1 1 49 1 49 1 48 1 1 1 3 1 1 1 1 49 1 49 1 50 1 50 
48 1 1 1 1 1 1 1 49 49 11 48 49 49 49 49 49 49 49 49 49 1 49 1 48 49 49 49 49 49 49 49 49 49 1 49 3 50 1 50 
48 49 49 49 50 1 50 1 49 49 1 48 1 1 1 1 1 1 1 3 1 1 49 1 1 1 1 3 1 1 1 49 1 1 1 49 1 50 1 50 
48 1 1 3 1 1 50 1 49 49 1 48 1 48 49 49 49 49 49 49 49 49 49 49 49 49 49 49 49 50 12 49 1 49 49 49 1 50 1 50 
48 1 48 49 49 49 50 1 49 49 1 48 1 1 1 1 1 1 1 1 3 1 1 1 1 1 1 1 1 1 9 49 1 49 1 1 1 50 1 50 
48 1 1 1 1 1 1 1 49 49 1 48 49 49 49 49 49 50 1 49 49 49 49 49 49 49 49 49 49 49 49 49 1 49 1 49 1 1 1 50 
48 1 48 49 49 49 50 1 49 49 1 48 1 1 1 1 1 50 1 49 13 10 12 49 1 1 1 1 1 1 1 1 3 49 1 49 49 50 1 50 
48 1 1 3 1 15 50 1 49 49 1 48 1 49 49 50 1 50 1 49 9 50 15 49 1 48 2 49 49 50 1 48 49 49 1 49 1 3 1 50 
48 1 48 49 49 49 50 1 49 49 1 1 1 49 3 50 1 50 4 49 15 50 1 49 1 48 14 1 1 50 1 1 1 1 1 49 1 48 49 50 
48 1 48 49 49 49 50 1 49 49 49 49 49 49 1 50 1 50 6 49 1 50 1 49 1 48 49 49 1 50 1 49 49 49 49 49 1 48 49 50 
48 3 1 1 1 1 1 1 1 3 1 1 1 1 1 1 1 50 1 49 1 50 1 49 3 48 1 49 1 50 1 49 1 49 1 1 1 1 1 50 
48 1 48 49 49 49 49 49 49 49 49 49 49 49 49 49 49 50 1 49 1 50 1 49 1 48 1 49 1 50 1 49 1 49 1 48 49 50 1 50 
48 1 48 1 1 1 1 1 1 1 1 49 1 1 1 1 1 1 1 49 1 50 1 49 1 48 1 49 1 1 1 49 1 1 1 1 1 1 1 50 
48 1 48 1 48 49 49 49 49 49 1 49 1 48 49 49 49 49 49 49 1 50 1 49 1 48 1 49 49 49 49 49 1 48 49 49 49 49 49 50 
48 1 48 1 1 1 1 1 1 49 1 49 1 48 1 1 1 49 3 1 1 50 1 49 1 48 1 1 1 3 1 1 1 1 1 1 1 1 1 50 
48 1 48 49 49 49 49 50 1 49 3 49 1 48 1 49 1 49 1 49 49 50 1 49 1 48 49 49 49 1 48 49 49 49 49 49 49 49 49 50 
48 1 48 3 1 1 1 1 1 49 1 49 3 1 1 49 1 1 1 49 3 1 1 49 1 1 1 1 49 1 1 1 1 1 1 1 1 1 1 50 
48 1 48 1 48 49 49 49 49 49 1 49 49 49 49 49 49 49 49 49 1 49 49 49 1 48 49 49 49 49 49 49 49 49 49 49 49 50 1 50 
48 1 48 1 48 1 1 1 1 49 12 1 1 1 1 1 1 3 3 1 1 49 1 1 1 1 15 49 14 1 1 1 1 1 1 3 1 1 1 50 
48 1 48 1 48 1 49 50 1 49 49 49 49 49 49 49 49 49 49 49 49 49 1 48 49 2 49 49 49 49 49 49 49 49 49 49 49 49 49 50 
48 1 48 1 48 1 49 0 12 49 1 1 1 49 1 1 1 49 1 1 1 49 1 1 49 1 1 1 49 1 1 3 49 1 1 1 49 6 49 50 
48 1 1 1 1 1 49 0 14 3 1 49 1 1 1 49 1 1 1 49 1 1 49 1 1 13 49 1 1 1 49 1 1 1 49 1 1 1 1 50 
48 49 49 49 49 49 49 49 49 49 49 49 49 49 49 49 49 49 49 49 49 49 49 49 49 49 49 49 49 49 49 49 49 49 49 49 49 49 49 50 