19 16
R R R R R R R R R R R R R R R R R R R
R R R R R R R R R R R R R R R R R R R
R R R R R R R R R R R R R R R R R R R
R R R R R G G G R R R R R R R R R R R
R R R R R B G G R R R R R R R R R R R
R R R R R G G B R R R R R R R R R R R
R R R G G B G B G R R R R R R R R R R
R R R G R G R R G R R R R R R R R R R
R G G G R G R R G R R R R R G G G G R
R G B G G B G G G G G G G G G G G G R
R R R R R G R R R G R G R R G G G G R
R R R R R G G G G G R R R R R R R R R
R R R R R R R R R R R R R R R R R R R
R R R R R R R R R R R R R R R R R R R
R R R R R R R R R R R R R R R R R R R
R R R R R R R R R R R R R R R R R R R
R R R R R R R R R R R R R R R R R R R